15 33
#################################
# # #        #           # #   *#
# # #### #####  # ######## ## ###
# #    # #  ### # #    ##  ##  ##
# #### # ## #   # ### ### #### ##
# #    # ## # ### #   ###       #
# # #### ## #   # # ### ####### #
# # ##    # ### #   ##     #### #
# #  #### #   # # #### #####    #
# ## ##   ###   #    #    ## ####
# ## ## ###   ###### ####    ####
#     # #   ###      ###### #   #
#####     ###   ######      ### #
#o    ###     #        ####     #
#################################