10 10
##########
# #      #
# # #### #
# # #* # #
# # ## # #
# #    # #
# # #### #
# ## o## #
#        #
##########